Hey there! If you're reading this, odds are I'm asking you for a job. Maybe I gave it to you in the hopes that you'd find me creative, skilled, or even just plain funny. This is interactive fiction, a genre that lies somewhere between a choose-your-own-story and a point-and-click adventure. This ride is only supposed to last about 5 minutes, so let's get right to it!

Mind Games
An Interactive Fiction by Giovanni Prinzivalli
Release 1 / Serial number 160211 / Inform 7 build 6M62 (I6/v6.33 lib 6/12N) SD

Room of New Beginnings
Well this should be an interesting interview, you think to yourself as you look up from your notes on the sturdy white conference table and out into the vast expanse of smooth white walls and bright white lights and a vaulted white ceiling. 

 *Blink* 

 What, what? You don't remember ever entering this room. One moment you were staring at the notes on the normally-tinted conference table of your normally-colored office, getting ready to interview a potential employee. The next, well… Weird. You pick yourself up out of the comfortable white chair. You should probably gather your notes, and look for an exit. 

You can see a conference table (on which are interview notes, an index card and a compass) here.

>take notes
Taken.

>take card
Taken.

>read card
You see nothing special about the index card.

>read notes
"Giovanni Prinzivalli", the name reads. Says here he studied both Sociology and Computer Science at Cal Poly. Wants to be a game designer. The game attached with his cover letter was kind of weird.

>e
Room of Old Beginnings

>w
Room of New Beginnings
The room is large, and L-shaped. Around the corner is the other half of the room. There is a sturdy white conference table, with a comfortable white chair.

* * *

>e
Room of Old Beginnings
The first thing you notice as you turn the corner is something distinctly not-white. It is so not-white, in fact, you can say with 100% certainty it is red. Everything else is still not-red. As you approach the door, you notice a white sign hiding on the wall, its letters a slight off-white. 

You can see a red door and a white sign (closed) here.

>s
(first opening the red door)
The door is locked. And red. There must be a key somewhere around here.

>e
Boiler Room

>e
Boiler Room Aft

>w
Boiler Room

>u
Scaffolding

>d
Boiler Room

>e
Boiler Room Aft

* * *

>w
Boiler Room

>w
Nexus of Personality

>n
Room of Old Beginnings

>w
Room of New Beginnings
The room is large, and L-shaped. Around the corner is the other half of the room. There is a sturdy white conference table, with a comfortable white chair.

You can see interview notes and an index card here.

* * *

>s
(first opening the red door)
The door is locked. And red. There must be a key somewhere around here.

>w
Altar to Skatan

>e
Nexus of Personality

>s
Reading Room

>s
Wall of Books

>u
Second Floor

>s
You can't go that way.

>d
Wall of Books

>n
Reading Room

>n
Nexus of Personality

* * *

>s
(first opening the red door)
The door is locked. And red. There must be a key somewhere around here.

>l
Room of Old Beginnings
 The eastern portion of the room is just as large and white as its counterpart. It is empty save for a red door to the south and a white sign hanging on the white wall next to it. 

You can see a wall sign (closed) here.

>touch sign
"Hey, easy! Not so rough there, pal. I'm sensitive, you know?" 

 Holy cow! The sign talks! You pinch yourself and - ow - remember that you can't wake up from pinching yourself. 

 "Cute. Listen, pal, the guy who runs this place needs your help with a problem. He's kind of fallen to pieces, literally. Could you do me a favor and put him back together? Don't worry, you won't be performing surgery or anything - just gather him up and bring him back here. You look like you're pretty sharp, so you'll be fine." 

 You stare at the sign, not quite over the fact that it's talking to you. 

 "Oh, and before I forget, you're gonna need this. Here." 

 The sign flips open, revealing a hidden in a recess in the otherwise unblemished white wall. Inside the recess is a red key.

>unlock door with red key
(first taking the red key)
You unlock the red door.

>open door
You open the red door.

>s
You can't go that way.

I beg your pardon?

>s
You can't go that way.

>s
You can't go that way.

>go door
You can't go that way.

* * *

>s
(first opening the red door)
The door is locked. And red. There must be a key somewhere around here.

>touch sign
"Hey, easy! Not so rough there, pal. I'm sensitive, you know?" 

 Holy cow! The sign talks! You pinch yourself and - ow - remember that you can't wake up from pinching yourself. 

 "Cute. Listen, pal, the guy who runs this place needs your help with a problem. He's kind of fallen to pieces, literally. Could you do me a favor and put him back together? Don't worry, you won't be performing surgery or anything - just gather him up and bring him back here. You look like you're pretty sharp, so you'll be fine." 

 You stare at the sign, not quite over the fact that it's talking to you. 

 "Oh, and before I forget, you're gonna need this. Here." 

 The sign flips open, revealing a hidden in a recess in the otherwise unblemished white wall. Inside the recess is a red key.

>s
(first opening the red door)
The door is locked. And red. There must be a key somewhere around here.

>take key
Taken.

>s
(first opening the red door)

Nexus of Personality
The sight that greets you is impressive. Cogs and gears taller than you and half as wide line the walls and spin in time with the thrum of some unseen engine. Normal color seems to have returned to the world, although the door behind you remains an obstinate red. You stand on a raised platform. A labyrinthine network of corridors serpent out below. A small, sturdy bridge extends out toward the center of the room, to another platform. You can make out a figure in a chair, and decide to proceed forward. Maybe he or she can tell you what's going on. 

You can see a red door, a south door, a west door, an east door and an old man here.

* * *

>take key
Taken.

>s
(first opening the red door)
Putting two and two together, you decide to use the red key on the red door. To the surprise of nobody, the key fits and the lock turns smoothly.

Nexus of Personality
The sight that greets you is impressive. Cogs and gears taller than you and half as wide line the walls and spin in time with the thrum of some unseen engine. Normal color seems to have returned to the world, although the door behind you remains an obstinate red. You stand on a raised platform. A labyrinthine network of corridors serpent out below. A small, sturdy bridge extends out toward the center of the room, to another platform. You can make out a figure in a chair, and decide to proceed forward. Maybe he or she can tell you what's going on. 

You can see a red door, a south door, a west door, an east door and an old man here.

>w
(first opening the west door)

Reading Room
 Towering bookshelves dominate this octagonal room, neatly arranged and tiered with ladders. Motes of dust float in the sunlight streaming in through vaulted windows, high above. In the back of the room is a wooden desk. You hear naught but the turning of pages every few minutes. Sitting behind the desk is a curiously familiar looking man wearing reading glasses, absorbed in some book. 

You can see a west door and a bookworm here.

* * *

>e
Room of Old Beginnings
The first thing you notice as you turn the corner is something distinctly not-white. It is so not-white, in fact, you can say with 100% certainty it is red. Everything else is still not-red. As you approach the door, you notice a white sign hiding on the wall, its letters a slight off-white. 

You can see a red door and a white sign (closed) here.

>w
Room of New Beginnings
 The room is large, and L-shaped. Around the corner is the other half of the room. There is a sturdy white conference table, with a comfortable white chair. 

You can see interview notes and an index card here.

>l
Room of New Beginnings
 The room is large, and L-shaped. Around the corner is the other half of the room. There is a sturdy white conference table, with a comfortable white chair. 

You can see interview notes and an index card here.

>x notes
"Giovanni Prinzivalli", the name reads. Says here he studied both Sociology and Computer Science at Cal Poly. Wants to be a game designer. The game attached with his cover letter was kind of weird.

>help
> Introduction to Mind Games
   Instructions for Play

>q
Room of New Beginnings
 The room is large, and L-shaped. Around the corner is the other half of the room. There is a sturdy white conference table, with a comfortable white chair. 

You can see interview notes and an index card here.

>e
Room of Old Beginnings
 The eastern portion of the room is just as large and white as its counterpart. It is empty save for a red door to the south and a white sign hanging on the white wall next to it.

>s
Nexus of Personality
The sight that greets you is impressive. Cogs and gears taller than you and half as wide line the walls and spin in time with the thrum of some unseen engine. Normal color seems to have returned to the world, although the door behind you remains an obstinate red. You stand on a raised platform. A labyrinthine network of corridors serpent out below. A small, sturdy bridge extends out toward the center of the room, to another platform. You can make out a figure in a chair, and decide to proceed forward. Maybe he or she can tell you what's going on.

>l
Nexus of Personality
 Gears and cogs line the vast walls of the nexus, and a maze sprawls below you. In the center platform of the room, there is an old man sitting in a white chair. There are doors across bridges north, south, east, and west of the platform. The door to the north is remarkably red.

* * *

>e
Room of Old Beginnings
The first thing you notice as you turn the corner is something distinctly not-white. It is so not-white, in fact, you can say with 100% certainty it is red. Everything else is still not-red. As you approach the door, you notice a white sign hiding on the wall, its letters a slight off-white. 

You can see a red door and a white sign (closed) here.

>touch sign
"Hey, easy! Not so rough there, pal. I'm sensitive, you know?" 

 Holy cow! The sign talks! You pinch yourself and - ow - remember that you can't wake up from pinching yourself. 

 "Cute. Listen, pal, the guy who runs this place needs your help with a problem. He's kind of fallen to pieces, literally. Could you do me a favor and put him back together? Don't worry, you won't be performing surgery or anything - just gather him up and bring him back here. You look like you're pretty sharp, so you'll be fine." 

 You stare at the sign, not quite over the fact that it's talking to you. 

 "Oh, and before I forget, you're gonna need this. Here." 

 The sign flips open, revealing a hidden in a recess in the otherwise unblemished white wall. Inside the recess is a red key.

>l
Room of Old Beginnings
 The eastern portion of the room is just as large and white as its counterpart. It is empty save for a red door to the south and a white sign hanging on the white wall next to it. 

You can see a wall sign (in which is a red key) here.

>x key
It's a key and it's red. Pretty basic stuff, really.

>x sign
You barely make out the words "Touch me!" on the sign.

In the wall sign is a red key.

>s
You can't go that way.

>take key
Taken.

>s
You can't go that way.

>srop key
That's not a verb I recognise.

>drop key
Dropped.

>unlock red door
What do you want to unlock the red door with?

>unlock red door with red key
(first taking the red key)
You unlock the red door.

>s
You can't go that way.

>open red door
You open the red door.

>s
You can't go that way.

>l
Room of Old Beginnings
 The eastern portion of the room is just as large and white as its counterpart. It is empty save for a red door to the south and a white sign hanging on the white wall next to it. 

You can see a wall sign (empty) here.

* * *

>unlock red door with red key
(first taking the red key)
You unlock the red door.

* * *

>l
Room of Old Beginnings
 The eastern portion of the room is just as large and white as its counterpart. It is empty save for a red door to the south and a white sign hanging on the white wall next to it. 

You can see a wall sign (empty) here.

>n
You can't go that way.

>w
Room of New Beginnings
 The room is large, and L-shaped. Around the corner is the other half of the room. There is a sturdy white conference table, with a comfortable white chair. 

You can see interview notes, an index card and a conference table (on which is a compass) here.

>e
Room of Old Beginnings
 The eastern portion of the room is just as large and white as its counterpart. It is empty save for a red door to the south and a white sign hanging on the white wall next to it. 

You can see a wall sign (empty) here.

>e
You can't go that way.

>w
Room of New Beginnings
 The room is large, and L-shaped. Around the corner is the other half of the room. There is a sturdy white conference table, with a comfortable white chair. 

You can see interview notes, an index card and a conference table (on which is a compass) here.

* * *

>unlock door with red key
(first taking the red key)
You unlock the red door.

>s
You can't go that way.

>open door
You open the red door.

>x door
You see nothing special about the red door.

>close door
You close the red door.

>lock door with red key
You lock the red door.

>open door
It seems to be locked.

>unlock door with red key
You unlock the red door.

>x door
You see nothing special about the red door.

>s
You can't go that way.

* * *

>go door
You can't go that way.

>open door
You open the red door.

>go door
You can't go that way.

I beg your pardon?

* * *

>unlock door with key
(first taking the red key)
You unlock the red door.

>s
(first opening the red door)

Nexus of Personality
The sight that greets you is impressive. Cogs and gears taller than you and half as wide line the walls and spin in time with the thrum of some unseen engine. Normal color seems to have returned to the world, although the door behind you remains an obstinate red. You stand on a raised platform. A labyrinthine network of corridors serpent out below. A small, sturdy bridge extends out toward the center of the room, to another platform. You can make out a figure in a chair, and decide to proceed forward. Maybe he or she can tell you what's going on. 

You can see a red door and an old man here.

>e
Boiler Room
Pipes line the walls and steam can be seen coming from various cracks and crevices. You've entered the boiler room, apparently. Halfway into the room, you notice a figure meditating, or is he just sleeping? To his left, a panel labelled "Furnace Controls" can be seen. Behind him is a large pit with a bridge spanning it. How cliche, you think. You can't make out what's on the other side without crossing. 

A big bridge leads west to the rest of the Boiler Room.

A steel ladder leads to some Scaffolding, but is retracted.

You can also see a meditator here.

>u
Scaffolding
Wow, this scaffolding is sturdier than it looks. The only thing of note up here is the ventilation unit adjacent to you. Behind you, the ladder goes back down to ground level. 

You can see a steel ladder here.

>x ladder
You see nothing special about the steel ladder.

>s
You can't go that way.